############
#1111223456#
#2221112335#
#4332125423#
#6544357523#
#7653236333#
#6432222122#
#4333223568#
#3212234455#
#6543578899#
#7532321357#
############