#######
#12134#
#3#245#
#62357#
#516#5#
#32123#
#######