############
#1111111111#
#1111111111#
#1111111111#
#1111111111#
#1111111191#
#1111111191#
#1111111191#
#1111111191#
#1111999991#
#1111111111#
############