############
#1111111111#
#1111111111#
#1111111111#
#1111111111#
#11111111#1#
#11111111#1#
#11111111#1#
#11111111#1#
#1111#####1#
#1111111111#
############