##########
#..#...#.#
#.##.#...#
#.#....#.#
#....#...#
#.#..#.###
###.##.#.#
#.#.#....#
#.....#..#
##########