#####################################################################################################
#.....#...#.#.....#.#...#...#.#.....#.#.........#...#.#.#.......#.#.#.#...........#.#.......#.#.....#
#.###.#.###.#.###.#.#.###.###.#.#.#.#.#.#########.#.#.#.#######.#.#.#.#.#####.#.###.#.###.#.#.###.###
#...#...#.#...#...#.......#.#.#.#.#.........#...#.#...........#...#...#.....#.#.....#.#...#.#.......#
#.#####.#.#.#.#.#####.#####.#.#####.#####.#.#.#.#######.#.#######.#.#.###.#.#.###.#.#.#.#####.#####.#
#.#.#.....#.#.#...........#.......#.....#.#...#...#.....#...#.......#.....#.#...#.#...#.....#.#...#.#
#.#.#######.#########.###.###.###.###.###############.#####.###.#######.###.#.#######.#.#####.#.#####
#.#...#.#.#...#.#.#...#...#.#.#.........#.#.#.........#.#...#.#.#.....#.#...#.......#.#...#.....#...#
#.###.#.#.#.#.#.#.###.#####.#.#####.###.#.#.#.#.###.###.#####.#####.#.#######.###.###.#########.###.#
#...#.......#.#.#...#.#.........#.#.#.#.#...#.#...#.............#.#.#.#...#.#.#...#...#.#...#...#...#
#.#####.#####.#.###.###########.#.#.#.#####.#.#######.###.#######.#.###.#.#.#.###.#####.###.###.#.###
#...#.#...#.....#.........#.#.....#.#.#.#...........#.#.........#...#...#.#.#...#...#.#.........#...#
#.#.#.#.#####.###.#.#######.#.#.###.#.#.###.#.#######.#########.#.#.#.#.###.#.#####.#.#######.#.#.###
#.#...#...#.#.#.#.#.#.........#.#.........#.#.#.....#.....#...#.#.#...#.......#...#...#.......#.#.#.#
#.###.#.###.#.#.#.#####.#.###.#.#.###.#######.###.###.###.###.#########.#.#.###.###.#####.#####.#.#.#
#...#.....#...#.#...#...#.#...#.#...#.#.#.....#.........#.......#...#.#.#.#.#.....#...#...#.........#
###.###.#######.###.#.###.#####.#.#.#.#.#.#.###.###.###.###.#######.#.#.#########.###.#.#####.#.#####
#...#.#.........#...#.#.#.....#.#.#.#.....#.#...#.....#.#.#.#.#.#.#.......#.....#.#...#.#.#...#.#...#
#.#.#.###.#####.#.###.#.#.#.#.#.#####.#####.#.#####.#.###.#.#.#.#.#####.#.#####.#.#.#####.#.#####.###
#.#...#...#.......#.....#.#.#.#.#.#...#...#.#.#.....#.#...#.#.#.#...#...#...#...#.#.........#.....#.#
#.#####.#########.#.###.#.#####.#.#.#.###.#####.#.#.#.###.#.#.#.#.#####.###.#.###.#.###.###.###.###.#
#.#.#.#...#...#.....#...#.#.#.....#.#...#...#...#.#.#.#...#.#...#...#...#.......#.....#.#.#.#...#.#.#
#.#.#.###.#.#.###.#.###.###.###.#.###.###.#######.###.#.###.#.###.#.###.#.#.#.###.#####.#.#.#.###.#.#
#...#.....#.#...#.#...#.#.#.#...#.#...........#.....#.#.....#.....#.....#.#.#...#...#.....#.#.......#
#.#######.#####.#####.###.#.#.###.###.###.#########.#####.#############.###.###.###########.#.###.###
#.#...#.#...#...#...#...#.#.....#.#.....#.......#...#...#.........#.#.#.#.#.#...#.#.#.#.....#.#.#...#
#####.#.#####.#.###.###.#.#########.#.#######.#####.#.#.#.#.#######.#.#.#.###.###.#.#.#.#####.#.#####
#...#.#.#...#.#...#.#...#.#...#.#...#.#.#.....#.....#.#...#...#.....#.....#.........#...#...#.......#
#.###.#.#.#####.#.#.#####.#.###.#######.#######.#####.#.#####.#.#.#.###.#####.#######.###.###.###.###
#.#...#.....#...#...#.#.........#.#.....#.........#...#.#.#.....#.#.....#...#.#.......#...#.#...#.#.#
#.###.#.#####.#####.#.#.###.###.#.###.#####.###.#.###.#.#.#######.###.###.###########.#.###.#.#.###.#
#...#.....#.......#.#.....#.#...#.#...#.#.....#.#.#.#.#.#.#.......#.#.#.#...#.........#...#...#...#.#
#.#######.###.#.#######.#########.#.###.#.#######.#.#####.#####.###.###.#.###.#.#######.#######.###.#
#...#.#...#...#.#.#.....#.#.#...#...#.#.#...#...#...#.....#.........#...#.#...#.#.#.......#.........#
#.###.#.###.###.#.#.#.###.#.###.#.#.#.#.#.#####.#.#.###.###.###.#.#.###.#.#.###.#.###.#.###.#########
#.....#...#...#.....#.....#.#.....#.#...#.#.....#.#.......#...#.#.#.....#.#.#.......#.#.#.....#.....#
#.#.###.###.#########.#.#.#.#.#######.#.#.###.#.#####.#.###.#.###.#####.#.###.#.#####.###.###.#.#.#.#
#.#.....#.....#...#.#.#.#.#.....#.....#.#.#.#.#.#.#...#.#.#.#...#...#.....#...#.#...#.......#.#.#.#.#
###.#.#.#.###.#.###.#########.#.#.###.#####.#.#.#.#.#####.#.#.#########.###.#####.###.###.#######.#.#
#.#.#.#.#...#...#.......#.....#...#.#.....#...#.........#.#.#.#...#...#...#.....#...#.#.....#.#.#.#.#
#.###.#########.#.###.#########.###.#.#.#####.#####.#####.#####.###.###.#.#####.#.###.#.#####.#.#.#.#
#.#.......#.#.......#...#...#.#.....#.#.......#.......#.#...#.....#...#.#...#.....#...#...#.#.....#.#
#.#.#####.#.#.#####.#.###.#.#.###.#.#####.###.#####.#.#.#.#.#.###.#.#.#.#.#.###.#.#.#####.#.#######.#
#.......#.......#.#.#...#.#...#...#.#.....#...#.#.#.#.#.#.#...#.#...#...#.#...#.#.#.#...........#.#.#
#######.###.#####.#.###.###.#.###.#####.#.###.#.#.###.#.#####.#.#########.#.###########.###.#####.#.#
#.#.......#.#...#.#.#...#...#...#.#.#...#...#.......#.#.#...............#.#...........#...#.........#
#.###.#.###.#.#.#.#########.#####.#.###.#######.###.#.#.###########.#.#######.#.###.#.#.#####.###.#.#
#.....#.#...#.#.....#.#.....#...#.#.....#.....#...#.#.#.#...#.......#.#...#.#.#...#.#.#.#.....#...#.#
#.#.#.#####.#.#.#.###.#.#.###.###.###.#.###.###.###.###.###.#.#########.###.#####.###.#.#.###.###.###
#.#.#...#.....#.#...#.#.#...........#.#.....#.#.#.#.#.#.....#.#...#.......#.#.......#...#.#.#.#.#...#
###.#####.#.#.#######.#######.#############.#.###.###.###.###.###.###.###.#.#########.#####.###.#.#.#
#...#.....#.#...........#.....#.#...#.#...#.#.....#...#.#...#.#.....#.#...#...#.......#...#...#.#.#.#
#####.#.#.#.#.#.###.#####.###.#.#.###.###.#.#####.###.#.###.###.###.#.#####.#######.#.#.###.#.#.###.#
#.#.#.#.#.#.#.#.#.........#...#.....#.......#.......#.......#.#...#...#.....#...#...#.......#...#...#
#.#.#.###########.#######.#.###.###.#.#####.#####.###.#.###.#.#.###.#####.#####.#####.#.#.#.#.#######
#.#.....#...#.#.#.#.....#.#...#.#.......#...#...#...#.#.#.........#.#.#.....#.#.#...#.#.#.#.#.......#
#.#.#.###.###.#.#######.###.#####.#.#####.#.#.###.###.#.###.#.#####.#.###.#.#.#.#.#####.#.#.###.#####
#...#.............#.....#...#...#.#.#.....#.#.....#...#...#.#.#.#.#...#.#.#...#...#.....#.#.#.#.#...#
#.#########.#.#####.###.###.#.#######.#######.###.###.###.#.###.#.###.#.###.###.#######.###.#.###.#.#
#.#...#.#...#.#...#...#.....#.......#...........#.....#...#.....#.#.......#.....#.#.......#.#.#...#.#
#.#.###.#######.#.###.#####.#.#.#######.#####.#.#.###.#######.###.###.###.#####.#.###.###.#.#.#.#####
#.#...#...#...#.#...#.#...#.#.#.......#.#.....#.#.#.....#...#.......#...#...#...#.#.#...#.#.......#.#
#.###.###.#.###.###.#####.#.#.###.###.###.#.#######.###.#.#.#####.#######.#.###.#.#.#.#########.###.#
#.#.........#.#.#.....#.#.....#...#.....#.#.#.....#.#.....#...#.#.......#.#.#.....#.#.#.#.....#.....#
#.#########.#.#####.#.#.#####.#####.###.#.#.#.#####.#.###.#.#.#.###.#####.###.#.###.#.#.#.#########.#
#.....#...#.........#.#...#.#.....#...#.#.#...#...#.#.#...#.#.#...#...#...#...#...#.....#.#.....#...#
#####.###.###########.#.###.#.###.#.###.#.#.#####.###########.#.#####.#####.###.#.#####.#.#.###.#.###
#...............#.#...#.......#...#...#.#.#.#...#.....#.....#.#...#.....#...#...#.....#.#...#.#.#.#.#
#######.#.#.#.###.#.#.#######.#.#.#.#######.#.#.#.#########.#.###.###.#.#.###.#############.#.###.#.#
#.......#.#.#.....#.#...#.#...#.#.#.#.........#.#.#...#.#.....#.....#.#.#.#.....#.......#.....#.#.#.#
#####.#####.###.###.#.###.#####.#######.#####.#.#.###.#.###.#.#####.#.###.###.#.#####.#.###.###.#.#.#
#.....#...#.#.#.#...#...#.#.#...#.......#...#.#.....#...#...#...#.#.....#.#.#.#...#...#...#.......#.#
#######.###.#.#.#.#####.#.#.###.#####.#.#.#####.###.#.#.###.#.###.#.#####.#.###.###.###.#####.#####.#
#.....#.......#...#.#.....#...#.#...#.#...#.....#...#.#.#...#.#...#.....#.#.....#...#...#.....#...#.#
#.#########.###.###.#######.#####.#.###.#.#.###.#.###.#####.###.#####.###.###.#.###.#####.#####.###.#
#.#...#.......#.....#...#...#...#.#.#...#.#.#...#.......#.......#...#.#...#...#.#...#.........#.....#
#.#.#####.#.#######.#.#####.###.#.#.#################.###.#######.#######.#####.#.#########.#.#####.#
#.#.#.#...#.....#.#.#.#.#.......#.#.......#.......#.....#.......#.......#.....#.#...#.#.....#.#...#.#
#.#.#.#####.#####.#.#.#.#####.#####.###.#######.###########.#####.#####.#.#######.#.#.#####.#.#.###.#
#...#.......#.#...#...#.#.....#.#.....#...#.#...........#.....#.#...#.........#.#.#...#.#...#.#.....#
###.#.#######.#.###.#.#.#.###.#.#.#######.#.#######.###.#.#####.#.#######.#.###.###.#.#.#####.#.#.#.#
#.....#...#.........#...#.#...#.#...#.#...#.#.#.....#.#.#.........#.#...#.#...#.....#.#.#.#.....#.#.#
#.#####.###.###.#######.#.#####.#.#.#.###.#.#.#######.#.#.#.###.###.###.#######.#####.#.#.###.###.###
#.........#...#.......#.....#.#.#.#.#...#.............#.#.#.#.....#.#...#...#...#.......#.....#...#.#
#.###.#.###.#.#####.#.#####.#.#.#.#####.#.###.#.#######.#.#######.#.###.###.#.#####.#.#####.#######.#
#.#...#.#...#...#.#.#.....#.#.......#.#.#...#.#.#.......#.#.#...#.....#...#.#.#.#.#.#...#...#...#...#
###.#.#####.#####.#######.###.#.###.#.#.#.#######.#####.#.#.###.#.###.#.###.###.#.###.###.#####.###.#
#.#.#.....#.#.....#...#.#...#.#...#.#.#...#.........#...#.#.....#.#...#.....#.#.........#...#...#...#
#.#.###########.###.###.#.#####.#####.###.#.###.#########.#.#####.###.#####.#.#########.#.###.#.###.#
#.............#.......#...#.....#.#...#.#.....#.#...#.........#...#.#.........#.........#.#.#.#...#.#
#.#.#######.###.#######.#######.#.###.#.###.###.#.#########.#.###.#.#.#.#####.#######.#####.###.###.#
#.#.....#.#...#.#.#.#.....#...#.......#.#.....#...#...#...#.#...#.#...#...#.#.#.......#.#...#.......#
#.#####.#.###.#.#.#.#.###.#.#.###.#####.###.#.#.#####.#.#.#.#######.###.###.#####.#####.###.#.###.###
#.#.........#...#.#...#.#.#.#.#.......#.#.#.#.#...#.....#...#.....#...#...#.....#...#.#...#.#.#.....#
###.#.#######.#.#.#.###.###.#####.###.#.#.#######.###.###.#.###.#.#.#.#####.#######.#.###.#.#.#.###.#
#...#...#.#...#...#.#.#.#.#...#.....#...#...........#...#.#.#...#...#.#...#...........#...#.#.#...#.#
###.#####.#.###.###.#.#.#.#.#.#.###.#.#####.#####.#####.#.###.###.###.#.###.###.#.#.#.###.#.#.#####.#
#.#.#...#...#.#...#.....#...#.#...#.#.....#...#...#.....#.#.#.#.#.#.......#.#...#.#.#.............#.#
#.#.###.###.#.###.#####.#.#.#.#.###.#####.#########.#######.#.#.#.#.#.#.#.###########.#.#####.#####.#
#...#...........#.#.......#.#...#...#.......#.......#.........#...#.#.#.#.............#...#.......#.#
#####################################################################################################