#######
#.#...#
#.#.#.#
#...#.#
#.###.#
#.....#
#######