#######
#.#...#
#.#.#.#
#...#.#
###.###
#.....#
#######