##########
#........#
#........#
#.....#..#
#.....#..#
#.....#..#
#..####..#
#........#
#........#
##########