#######
#.....#
#.#.#.#
###..##
#######