######
#..#.#
#.##.#
#.#..#
######